7 10
0000000000
0111111110
0100000010
0103110110
0100010100
0111110120
0000000000

%500
