5 9
000000000
021011130
001110100
001010100
000000000

%50
