7 10
0000000000
0111111110
0100010010
0113010110
0010011100
0111110120
0000000000

%200
